############
#.....$....#
#..#....#..#
#..........#
#.$...#....#
#....##....#
#........#.#
#..#..$....>
#.......#..#
############
