#################
<.....#....#....#
#...............#
#...#....#..$...#
#...$...........#
##............###
#..#..#.........#
#...#...$.......#
#............#..#
#.......#..$.#..#
#..##...........>
#......$..##....#
#################
